antes de - before __
entro - i enter
el domingo - sunday
descanso - break / rest
ayuda - help
ahora - now (but in SA means soon or later hehe)
hoy - today
hay - there are
Que voy a hacer? -  What am I going to do?
la semana pasada - last week
* dos dias atrás - two days ago
no importa - doesn't matter
no me importa - I don't care
hacer - to do / to make / to cause
sabes - you know

que pasa si... (what happens if)
la tienda - store
¿Puedes darme / traerme....: "Can you give me / bring me..."

mientras - while
como - like (or how)
hacia - towards / to (e.g. estoy yendo hacia tu casa)
mismo - right now
pensar - to think
verdura - vegetable

esta / este - this
esto - this (for situation  / idea)
estos / estas - these
ese / esa - that
eso - that (for situation / idea)
esos / esas - those

algunas veces - some times
a veces - at times
alguna - any

adelante - forward
derecho - straight
