mirar  - to see
buscar - to search
silla - seat
boligrafo, esfero, lapicero (colombia) - pen
lapiz - pencil
gorro - hat
gusano - insect
gitanos - gypsies
ser - to be (permanent)

mochila - backpack
pais / paîs - country
mochilero, mochilera - backpacker
meter - to put in
comprar - to buy
sellos - stamps
abrir - open
coger - take
cerrar - to close
vivir - to live
trabajar - to work
abecedario, alfabeto - alphabet
tirar - to throw
papelera - garbage can
futbolista - football player (no
vieja / viejo - old
pequeno - small
moderno - modern

grande - large
llena - full (a room or a person)
rotulador - marker
cuaderno - notebook
consancio - tire
hambre - hunger
sed - thirst
edad - age
pelo - hair
largo - long
describir - describe
usamos - we use
joven - young
género - gender
gordo - fat
moreno - brown skin
bajo - short
delgado - slim
rubio - blond
antipatico - unfriendly
listo - ready or smart
nervioso - nrvous
divertido - fun
malo - bad
trabajador - worker
hablador - talks a lot
fumador - smoker
fuerte - strong, loud
débil - weak
joven (gender neutral) - young
interesante (gender neutral)- interesting
inteligente (gender neutral)- smart
fuerte (gender netural) - strong
calvo - bald
bigote - mustache
barba - beard
muscoloso - muscley

- bigote: mustache
- barbada: beard
- pelo: hair
  - largo: long
  - corto: short
  - liso: smooth
  - crespo: curly
  - rubio: blond
  - (in Medellin) monos: blond, outside monkey
  - rojo: red
- ojos: eyes
  - verdes: green
  - negros: black
  - azules: blue
  - cafés: brown
  - gris: gray
  - comisa: shirt ??
  - camiseta: shirt
  - pantalón
  - falda: skirt
  - gafas: glasses
  - sandalias: sandles
  - botas: boots
  - tenis: tennis shoes
  - corbata: tie
  - vestido: dress
| tener    | se                       |
|----------|--------------------------|
| blanca   | blanca (white)           |
| morena   | morena (brown)           |
| amarilla | triguena  (yellow)       |

vendeolor - salesman
músico - musician
sustantivo - noun
ahora - now
Lavar: to wash
Beber: to drink
Vivir: to live
Comprar: to buy
Cenar: eat dinner
Necesitar: to need
Dibujar: to draw
Pintar: to paint
preparar: to prepare
tomar:  to take / to drink
llevar: to bring
descansar: to rest
llamar: to call
viajar:  to travel
caminar:  to walk
trabaajar: to work
partir: to separate
abrir: to open
escribir: write

carro - car
coche - car
estos - these
esto - this
quien- who
bicicleta - bicycle
monedas - coins
vaqueros - cowboy
jersey - sweater
la ropa interior - underwear
los pantalones vaqueros - "cowboy pants" / jeans
cuero - leather
abrigo - jacket
seda - silk
pijama - pijamas
calcetinas / medias - socks
zapatos - shoes
desordenados - messy / disorganized
correa - belt
camisa - shirt
compañero - companinon
chaqueta - jacket
gorra - cap / hat
cartera - purse
piso- floor
novio - boyfriend
novia - girlfriend
hijo - son
habitación - bedroom
jardín - garden
hoy - now (pronounced oy)
describir - to describe
bermudas - shorts / short pants
calzoncillos - briefs
camiseta - t-shirt
reloj - clock, watch
plata - money

- En frente de: in front of
- al lado: next to
- al lado izquierdo de: to the left of
- al lado derecho de: to the right of
- Detrás de:  behind
- Adentro de: inside of
- afuera de: outside of
- entre: between
- encima de: ou top of
- debajo de: under

la mano - hand (feminine)
las manos - hand
la moto - motorcycle
sobre - about / envelope

espejo - mirror
cómodas / comodas - comfortable
oscuars - dark
móvil / movil - mobile, moving
entonces - then
lejos - far
circa - near
carpeta - carpet
esos - those
saber - to know
estanco - store
puerta - door

ubicacion  - location
barrio - neighborhood
aburrido - boring
tráfico - traffic
deportes - sports
taberna - tavern
arboles / árboles - trees
hoy - now
ayer - yesterday
ahora - today
huéspedes - guest

primero - first
segund - second
tercer - third
cuarto - fouth
quinto - fifth
sexto - six
séptimo - seventh
octavo - eigth
novena - ninth
décimo - tenth
vocálicos - vowel

- la salón: living room
- el sofá: sofa
- el televisor: television / tv
- el cama: bed
- la estanteria: shelves
- el ordenador (spain) / computador (latin): computer
- la silla: chair
- el comedor: dining room
- la mesa: table
- el lavabo: bathroom
- la chimenea: fireplace
- el garaje: garage
- la terraza: balcony, terrace
- la despacho: office
- la sala: room
- el jardín / jardin: garden
- el dormitorio: room
- el aprtimento: partment
- la cocina: kitchen
- el lavaplato: dishwasher
- el horno: oven
- los pisos: floors
- los muebles; furniture
- el cojínes / cojines: cushion
- las escaleras: stairs
- el eléctricas: elevator
- el elevador: elevator
- la biblioteca: library
- la cosa: thing
- la nevera - refrigerator / fridge
- la puerta - door
- cochino - dirty

entender - to understand
comenzar - to begin / commence
perder - to lose
pensar - to think
poder - to can (you can sleep). always has infinitive after it (no puedo dormir)
encontrar - to find
volver - to return
pedir - to ask for
vestirse - to get dressed
servir - to serve
jugar - to fly
empezar - to start
dormir - to sleep
querer - to want
necesitar - to need
preferir - to prefer
poder - can
hacer - to do / to make / to cause
viaje - journey / trip (noun)
cambiar - to change / to switch
pensar - to think
siempre - always
quedarse / quedasmos - to stay
amo - love
pasarme - to come / go / pass
algo - something / anything
eso - that / it
vender - to sell
carrera - to run
el parque - park
